 公司名稱	連絡人	email	業務
三豐超硬模具有限公司	林忠智	sfd@sfd.com.tw	陳如玉
川口工業股份有限公司	陳登旺	chuankow@chuan-kow.com.tw	吳文華
天文企業股份有限公司	陳淑美	tianwun@tianwun.com.tw	數位行銷事業部
匠門企業股份有限公司	張美麗 / 謝芳玫	jiangmen@jiangmen.com.tw	李慧菁
吉強科技有限公司	陳俊隆	gcdesign@gcdesign.com.tw	吳文華
亞力士電腦機械股份有限公司	楊義成	arixservice@arix.com.tw	李慧菁
金岩實業股份有限公司	李進東	kinga@kinga.com.tw	陳如玉
信錦企業股份有限公司	劉威宜	syncmold@syncmold.com.tw	陳如玉
品祥股份有限公司	沈炎坤	pinghsiang@pinghsiang.com.tw	陳如玉
真善美科技股份有限公司	林碧芳	cindylin@jasmin.com.tw	吳文華
盛泰防災工業股份有限公司	劉源弘	sato@shengtai.com.tw	陳如玉
睿志科技有限公司	林建信	ivy.wang@wisdom.com.tw	陳如玉
銳盟實業有限公司	詹淑華	race@racemold.com.tw	姚仁智
聯和鋼模子股份有限公司	張勝金	sales@lienwang.com.tw	數位行銷事業部
雕坊科技有限公司	盧芬芳	signgrafs@signgrafs.com.tw	陳如玉
唐德材料科技股份有限公司	鄭仁傑	tpial@tpial.com.tw	李慧菁
揚程儀器工業有限公司	陳蔡和	youngchenn@youngchenn.com.tw	數位行銷事業部
裕強精密工業股份有限公司	翁玉炎	ycpi@ycpi.com.tw	數位行銷事業部
萬達電熱有限公司	陳達夫	wandah@wandah.com.tw	姚仁智
天海味食品股份有限公司	謝進財	thw@thwei.com.tw	數位行銷事業部
馥陞企業有限公司	王建雄	fuson@fuson.com.tw	李慧菁
合全產品開發股份有限公司	黃舒伶	sundar@sundar.com.tw	數位行銷事業部
佛泰企業股份有限公司	胡展榮	tungtay@tungtay.com.tw	李慧菁
京杰企業有限公司	林總經理	king@kingpack.com.tw	姚仁智
天盛鐵工廠有限公司	林錦銘	tsm@tsm1975.com.tw	數位行銷事業部
翰詮實業有限公司	陳政文	eaq@eaq.com.tw	吳文華
協立機械股份有限公司	杜明慶	tps@slmc.com.tw	姚仁智
采宏國際有限公司	盧芬芳	farbgrafs@farbgrafs.com.tw	陳如玉
盛彗電器有限公司	徐年富	soundway@soundway.com.tw	姚仁智
鋒泉螺釘股份有限公司	楊志清	lslin@fontec.com.tw	姚仁智
嘉揚興業有限公司	吳新	chiayang@chiayang.com.tw	吳文華
正將油墨股份有限公司	吳苑瑜	3377@jetjun.com.tw	吳文華
阜達股份有限公司	周書勇	davidchou@pf.com.tw	數位行銷事業部
勤豐鋁業股份有限公司	張郡瑋	info@altec-group.com	李慧菁
台灣集合工業有限公司	張國義	harvocut@bizmial.com.tw	數位行銷事業部
豪情股份有限公司	廖育概	motel@wsb-motel.com.tw	李慧菁
尚磔工業有限公司	周憲政	shanq@shanq-jer.com.tw	李慧菁
亞帝熱導科技有限公司	黃良王夫	attic@attic.com.tw	陳如玉
煜林企業股份有限公司	王開煜	2434999@yu-lin.com.tw	李慧菁
陽明山中國麗緻大飯店	蘇祐琦	salesy@landisresort.com.tw	數位行銷事業部
慧堡科技有限公司	王昭昌	sales@huibao.com.tw	姚仁智
耑北企業有限公司	周文立	adc@adc89.com.tw	數位行銷事業部
鑫晟事業有限公司	林宏昇	stamp@mystamp.com.tw	數位行銷事業部
亞太菁英股份有限公司	葉明岳	yeh@apeccnc.com	李慧菁
勤城工業有限公司	江振嘉	chyngcheng@chyngcheng.com.tw	姚仁智
恆君精密工業股份有限公司	方俊朝	tinaf@everjuan.com.tw	陳如玉
岳傑企業有限公司	胡大煒	gpioneer@gpioneer.com.tw	吳文華
八方國際翻譯有限公司	莊曉玲	cindy@tlink.com.tw	數位行銷事業部
瀚奕企業有限公司	林祈男	chi.fu@yuee-how.com.tw	陳如玉
黑金鋼股份有限公司	鈕光明	kinggold@bizmail.comt.w	數位行銷事業部
豐展塑膠有限公司	黃稟豈	bags@bags86.com.tw	數位行銷事業部
加堤企業有限公司	薛如芳	vernessa@eyecareeyewear-tw.co	李慧菁
優模科技股份有限公司	黃保郎	office@unimold.com.tw	李慧菁
聯好企業有限公司	莊靖昇	gimibear@gimibear.com.tw	李慧菁
辰曜企業有限公司	陳俊良	sunny@sunnymold.com.tw	陳如玉
台灣塑膠機械產業有限公司	曾漢斯	tpmc@taiwanplastic.com	陳如玉
助忻實業有限公司	謝宗興	gladaid@gladaid.com.tw	吳文華
友育冷凍機械工業有限公司	張清隆	service@yeouyuh.com.tw	陳如玉
美得興業有限公司	高義勇	mada@mada.com.tw	陳如玉
洗福機械工業有限公司	劉德圖	service@shiifure.com.tw	姚仁智
嶸驊企業有限公司	郭秀蘭	info_vn@ynghua.com	李慧菁
金碧實業股份有限公司	李進東	kingb@king-b.com.tw	陳如玉
能率倉儲設備股份有限公司	徐兆民	service@acmerack.com.tw	數位行銷事業部
合晟光學企業有限公司	簡賓宏	service@hco.com.tw	吳文華
台芯實業股份有限公司	張志傑	ccchang@taiwanhoneycomb.com.tw	數位行銷事業部
黃麗花	黃麗花	js@js-accessories.com	李慧菁
樸石旅館股份有限公司	張祖榮 / 吳家儀	service@pauselandis.com.tw	數位行銷事業部
喬健貿易股份有限公司	陳美紅	jd@win-sonic.com.tw	陳如玉
中國消防實業有限公司	張政裕	cff@cff.com.tw	陳如玉
信咚企業股份有限公司	鍾佩祈	sales@laserss.com	李慧菁
洪獻軍 / 洪勝興	洪勝興	molder-biz@molder-biz.com	數位行銷事業部
奧威廣告	吳國安	andy@alliance-ad.com.tw	吳文華
三浦鍋爐股份有限公司	鄭振凌	service@miuraz.com.tw	吳文華
皓毅股份有限公司	溫適瑜	lp@lh-group.com.tw	李慧菁
瑋翔精機有限公司	蔡小姐	wh@weihsiang.com.tw	陳如玉
茱莉莎菲國際有限公司	陳若愚	william@noblelink.com.tw	數位行銷事業部
進文貿易有限公司	王敬煌	service@jmsc.com.tw	姚仁智
晨達精密工業股份有限公司	吳志鴻	chengda@chengda.com.tw	姚仁智
優鑽國際有限公司	謝佳蓉	customer@yvonneyang.com.tw	吳文華
光韻科技股份有限公司	陳先生 / 李先生	ivyyen@nanolight.com.tw	陳如玉
淶得有限公司	李文佑	steve_lee@rapid.com.tw	數位行銷事業部
大堅科技有限公司	謝璧如	gloria@tachien.com	陳如玉
璨郁實業有限公司	林文峰副總	eric@gty.com.tw	陳如玉
新盈商標設計有限公司	陳進益	et@et168.com.tw	數位行銷事業部
牛津語文有限公司	牛主任	superme@superme.com.tw	陳如玉
凱樹建材有限公司	陳泓儒	ks@ksv.com.tw	吳文華
中華標記有限公司	吳進添	info@cnp-co.com.tw	吳文華
台灣村田板金企業有限公司	林先生	ct@taiwan-mulata.com.tw	陳如玉
名品坊股份有限公司	謝淑珍 總經理 		陳如玉
元信豐企業股份有限公司	蔡秀徵	ysf@ysf-mold.com.tw	吳文華
艾迪曼創意工坊	邱一峰	scott_chiu@ideamanevent.com	陳如玉
緯達皮革有限公司	溫小姐	jessie@weitai.cn	李慧菁
益歐股份有限公司	郭中屏 總經理	eo@cocosure.com.tw	數位行銷事業部
慶羿企業有限公司	高小姐	uuiajgi@uuiajgi.com.tw	陳如玉
裕鑫彈簧有限公司	黃先生 / 吳朝良	sales@yuhsing.com.tw	陳如玉
凱迪興業股份有限公司	林小姐	林靜婷 tioc@tioc.com.tw	陳如玉
聯茂鋼模股份有限公司	何小姐	lienmao@lienmao.com.tw	陳如玉
智學科技股份有限公司	廖俊豪	5690@5690.com.tw	姚仁智
杰慶國際有限公司	林新財 / 陳小姐	info@ccip.com.tw	吳文華
明紳國際有限公司	金冠正	customersupport@peguda.com	姚仁智
呈洋系統科技股份有限公司	王嘉彬	vincent@cyst.com.tw	李慧菁
大利特殊鋼股份有限公司	陳炳坤 副總	sales@tahlee.com.tw	陳如玉
和氏璧國際股份有限公司	李先生	sales@flawlessstone.com.tw	陳如玉
泰浩企業有限公司	張文碩	tieus@qqkit.com.tw	吳文華
英屬維爾京群島商訊達顧問有限公司台灣分公司	鄭雅惠 / 張涵瑜	claire@apr-ksp.com.tw	陳如玉
日月企業社	藍淑芬	sales@sm-chopsticks.com.tw	陳如玉
達奈美克科技有限公司	廖斌宏	service@dmark.com.tw	數位行銷事業部
銘墅空間設計有限公司	黃俊源	27204941@m-shu.com.tw	李慧菁
中山新濠電子科技有限公司	黃銘弘	service@xinhao-tech.com	陳如玉
聖光科技有限公司	林繼興	saint@saintlight.com.tw	吳文華
十指美學	莫雅筑	coco.mo@beauty-finger.com.tw	李慧菁
智晟貿易股份有限公司	陳麗婷	mmychen@hi-safe.com.tw	李慧菁
連鎮水電工程有限公司	黃春有	lianchen@lian-chen.com.tw	李慧菁
德銀實業有限公司	潘英台	service@kayin.com.tw	姚仁智
勝宏機械工業股份有限公司	余俊憲	shenghong@shenghong.com.tw	陳如玉
中順電熱計器有限公司	周宜順/周宜忠	service@chungshun.com.tw	陳如玉
十德科技股份有限公司	甯葦僑	july.h@tensco.com.tw 	李慧菁
佑通通信工程有限公司	小李	user7530@e-user.com.tw	陳如玉
尚田企業有限公司台中分公司	蔡馨慧	books@my-best.com.tw	李慧菁
翰林紙品企業有限公司	張文寧	cwcom93@giga.net.tw	陳如玉
大桐模具工業股份有限公司	吳錦文 總經理	alan@greatmold.com.tw	陳如玉
台灣精密齒輪工業股份有限公司	楊垂恭	tpg@tpg.com.tw	李慧菁
正浚機械工業有限公司	廖正銈	jenqjiunn@jenqjiunn.com.tw	陳如玉
同院鑄造工廠股份有限公司	高添發	tungyuan-f@tungyuan-f.com.tw	姚仁智
利保烙印標企業股份有限公司	祝競倫	leebou@leebou.com.tw	李慧菁
機鎂企業股份有限公司	林淵祥	jesse@chiaiuan.com.tw	數位行銷事業部
坤誠精密工業股份有限公司	李淑貞	comtech@com-tech.com.tw	陳如玉
欣昊實業股份有限公司	周時屏 / 王鎮城	wvision@mastercam.com.tw	陳如玉
欣展塑膠股份有限公司	朱淑惠	evertech@ever-tech.com.tw	李慧菁
冠齊資訊有限公司	賴齊宏	cimatron@cimatron.com.tw	陳如玉
倚碩科技股份有限公司	蘇德正	esoft@esoft.com.tw	數位行銷事業部
富雄鋼模廠股份有限公司	陳建良 / 張小姐	fuhsiung@fuhsiung.com.tw	李慧菁
竣盟工業股份有限公司	蔡崇志 / 楊小姐	sales@gunion.com.tw	姚仁智
萬通模具工業股份有限公司	林家雄	iu_shing2005@yam.com	陳如玉
萊俐設計裝潢有限公司	黃仰鐘	laili@rds.com.tw	數位行銷事業部
香港商昂睿科技有限公司台灣分公司	李嘉佳	onsoftwarei@onsoftwarei.com	數位行銷事業部
金貿興企業股份有限公司	吳翠容	hsiehyi@hsyimold.com	數位行銷事業部
坤法企業有限公司	陳冠宏	quen_fa@mail.mold.com.tw	李慧菁
禾乘企業有限公司	趙梨伶	hercheng@hercheng.com.tw	李慧菁
合宏展工業有限公司	蘇世欽	hong.jung@hhj.com.tw	數位行銷事業部
貫捷電子有限公司	張明宗	anige.wu@guannjye.com.tw	陳如玉
元鐙金屬股份有限公司	王惠美	business@yuandeng.com.tw	數位行銷事業部
聞祺企業有限公司	張小姐	aggie@wenchi.com.tw	李慧菁
順億機械股份有限公司	黃晴惠	sunyouth@sunyouth.com.tw	姚仁智
昶昇科技股份有限公司	陳泰然	ken@sunvision.com.tw	陳如玉
電贏行電子股份有限公司	陳亞琦	ups@powerbank.com.tw	吳文華
宏奇泵浦工業有限公司	黃世章	stairs@stairs.com.tw	陳如玉
華釜自動精機實業有限公司	陳坤煌	hwafu@hwafu.com.tw	數位行銷事業部
亞洲英傑科技股份有限公司	曾志平	tseng@coolmartinz.com.tw	姚仁智
禾寶興業有限公司	朱右伯	hobao@hobao.com	陳如玉
新柏工業股份有限公司	吳丰谷	newsymbol@newsymbol.com.tw	姚仁智
億兆科技股份有限公司	呂建邦 / 吳天健	tcwu@endpoints.com.tw	數位行銷事業部
康悅美容事業股份有限公司	陳姵蓓	kangyue@naven.com.tw	數位行銷事業部
志易資訊社	方曉婷	av@av.club.tw	數位行銷事業部
隆怡工業股份有限公司	何文賢	ly@loongyee.com.tw	陳如玉
宏芯科技股份有限公司	彭儷雯	charlesw@terawins.com.tw	數位行銷事業部
世界鎖具股份有限公司	邱秀娟	w135@worldlock.com.tw	數位行銷事業部
忠誠書報社	黃環益	18book@18book.com.tw	陳如玉
飛虹國際整合行銷公關顧問有限公司	黃夢寧	tiffany_huang@fay.com.tw	吳文華
國立成功大學機械工程學系	羅副主任	loyl@mail.ncku.edu.tw	李慧菁
台北市私立大湖汽車駕駛人訓練班	劉紹康	dahu@dhdt.com.tw	數位行銷事業部
勤工企業有限公司	張哲維	service@hardwork.com.tw	姚仁智
覲得有限公司	游淑慧	interior@jiinder.com.tw	數位行銷事業部
鼎峰塑膠機械股份有限公司	黃小君	leader@leadertw.com	李慧菁
喬章實業股份有限公司	林國欽	chiaocha@giga.net.tw	姚仁智
貫豐興業有限公司	魏逢延	guanfong@guanfong.com	姚仁智
精崧有限公司	何建源	zyver@ms34.hinet.ne	陳如玉
淞協企業股份有限公司	陳姿秀	sunsda@sunsda.com.tw	陳如玉
連順企業有限公司	洪建銘	ming@lianshuenn.com.tw	陳如玉
異翔工業股份有限公司	甘哲人 / 黃永平	service@eico.com.tw	數位行銷事業部
亞克翔捷股份有限公司	徐榮章	jimmy@arrkshangent.com	陳如玉
吉台工業股份有限公司	吳登山	gipup@mold.com.tw	數位行銷事業部
盟訊實業股份有限公司	莊秀櫻	unication@uni.com.tw	陳如玉
勝新金屬股份有限公司	陳淑玲	shenghsin@bizmial.com.tw	李慧菁
螺曜(螺展)螺絲金屬股份有限公司	陳振民	sales@mail.luochan.com	陳如玉
世大興業有限公司	呂柏乾	webmaster@neogolf.com.tw	李慧菁
顯祥國際實業股份有限公司	賴文卿	emily@mail.3-proshop.com.tw	李慧菁
德奕泰禮贈品購物網	顏蜻誼	sales@holdermold.com	陳如玉
建霖生化科技有限公司	羅小姐	alexchiou@ebtnet.net	數位行銷事業部
二億企業股份有限公司	施佳慧	service@ecigroup.com.tw 	李慧菁
邦拓生物科技股份有限公司	鄭淑允	sales@bioteq.com.tw	陳如玉
首利實業股份有限公司	潘小姐	dinna_pan@soly-tech.com	陳如玉
奇哥股份有限公司	馮湘琪	connie@chick.com.tw	數位行銷事業部
台南市南區戶政事務所	郭孟淑	tnscg10@mail3.tncg.gov.tw	李慧菁
樂生療養院	張小姐	irene@lslp.doh.gov.tw	陳如玉
黃斐詩	黃斐詩	fhuang@ilevelu.com	陳如玉
行達電工器材有限公司	張小姐	ronsun@syndex.com.tw	陳如玉
元能股份有限公司	謝淑芬	vicky@yuenneng.com	李慧菁
慶興精密科技股份有限公司	黃玉娟	penny@cspt.com.tw	李慧菁
合商企業有限公司	何舜耕	rita@lampelves.com	陳如玉
廣碩光電材料股份有限公司	唐先生	rest1@dynatrong.com.tw	陳如玉
阿魯特國際股份有限公司	許約翰	johnny.h@altec-group.com	李慧菁
惠鴻資訊管理顧問股份有限公司	鄭小姐	kini@nubody.com.tw	陳如玉
國維聯合科技股份有限公司	王湞元	taipei@wei-han.com	陳如玉
金萬財股份有限公司	蔡丁曉薇	kot@wy.com.tw	李慧菁
渤揚股份有限公司	蕭妙真 副課長	mandy.hsiao@pepwing.com	陳如玉
久禾達工業股份有限公司	江雅瑛	michelle@jhd.com.tw	李慧菁
嘉仕通豐業有限公司	陳啟宏	info@acecloth.com	李慧菁
遠東國際商業銀行股份有限公司	范雅婷	fanfan1022@feib.com.tw	陳如玉
偉博應用科技有限公司	楊青峰	paulyang@vtlg-asia.com	陳如玉
青雲視訊股份有限公司	廖永豐 經理	roger@chun.com.tw	陳如玉
冠天科技股份有限公司	黃立吉 總經理	jackey@guidetek.com.tw	陳如玉
和泰股份有限公司	許峰維 	fwshiu@mail.hotai.com.tw	陳如玉
昀辰企業有限公司	藍驥續 經理	sales-1@triplus.com.tw	陳如玉
光電科技工業協進會	張雪卿	cathy@mail.pida.org.tw	陳如玉
懋莉工業股份有限公司	賈志傑	jameschia@mony.com.tw	陳如玉
宏光光電股份有限公司	王品文	calvin@optofocus.com	陳如玉
旭岡科技有限公司	王怡文	evenwang@sae-model.com	陳如玉
系曠科技股份有限公司	黃斐詩 副總	faith@heehaa.com.tw	陳如玉
茂迪股份有限公司	顏怡民 副理	ym_yen@motech.com.tw	陳如玉
羅倫斯國際教育中心	吳依倩 主任	irene@apec.org.tw	陳如玉
陸海洋行股份有限公司	柯育琪 副理	marketing@sealand-deluxe.com.tw	陳如玉
圓智科技股份有限公司	洪一中	grand@grand.com.tw	陳如玉
廣吉食品股份有限公司	賴穎俊 主任	aadylai@kugifoods.com.tw	陳如玉
瑛煥國際有限公司	鄭怡琳	ally@eflair.com.tw	陳如玉
匯僑設計興業有限公司	謝禎舜	andre@richhonour.com	陳如玉
正隆股份有限公司	張文聰 課長	wtchang@mail.clc.com.tw	陳如玉
男仕禮服公司	李昶頡 協理	Jay@gem-man.com.tw	陳如玉
江文良土木結構技師事務所	莊惠雅	192681@ms58.url.com.tw	陳如玉
崑育工業社	林裕凱	kun-yuh@cttnet.net	陳如玉
函數科技股份有限公司	陳逸玲 課長	nicole_chen@fabiatech.com	陳如玉
嘉元不動產經紀有限公司	林南宏 店東	a254@mail.hbhousing.com.tw	陳如玉
圓澤股份有限公司	廖華芳	christine@yuantse.com.tw	陳如玉
千紀實業有限公司	陳裕哲 經理	mike@cefal.com.tw	陳如玉
和法實業股份有限公司	周天瑩	nerissa@ms94.url.com.tw	陳如玉
沅傑企業有限公司	蘇進鶴	shincosu@yensay.com.tw	陳如玉
祥億汽車貨運股份有限公司	楊博文 課長	dou1ton0945@sinamail.com	陳如玉
佑祥興業股份有限公司	張慶堂 總經理	service@allblessing.com.tw	陳如玉
伊豆國際股份有限公司	李中褘 副總	douglas@etou-holiday.com.tw	陳如玉
伊斯頓資訊企業社	潘孝義	spp@esystem.com.tw	陳如玉
國立臺灣大學國際學術交流中心	郭芠	cfia@ntu.edu.tw	陳如玉
美商瑞達無線科技股份有限公司	陳怡伶	Vickey.Chen@tw-rdwic.com	陳如玉
智慧有機體股份有限公司	游宜芬 總經理	sophie.yu@smartbio.com.tw	陳如玉
松記食品工業有限公司	汪張源	sungchi@twt1.com.tw	陳如玉
安尼可有限公司	劉俊廷	aniko@ebtnet.net	陳如玉
基督新報	林國靖	alan@gospelherald.com.tw	陳如玉
秦典實業有限公司	陳孟嘉	yvonne.chen@chanting-rep.com.tw	數位行銷事業部
